id,activity_date,total_steps,very_active_minutes,fairly_active_minutes,lightly_active_minutes,sedentary_minutes,calories,active_minutes
1503960366,2016-03-25,11004,33,12,205,804,1819,45
1503960366,2016-03-26,17609,89,17,274,588,2154,106
1503960366,2016-03-27,12736,56,5,268,605,1944,61
1503960366,2016-03-28,13231,39,20,224,1080,1932,59
1503960366,2016-03-29,12041,28,28,243,763,1886,56
1503960366,2016-03-30,10970,30,13,223,1174,1820,43
1503960366,2016-03-31,12256,33,12,239,820,1889,45
1503960366,2016-04-01,12262,47,21,200,866,1868,68
1503960366,2016-04-02,11248,40,11,244,636,1843,51
1503960366,2016-04-03,10016,15,30,314,655,1850,45
1503960366,2016-04-04,14557,43,18,285,757,2030,61
1503960366,2016-04-05,14844,36,18,341,736,2083,54
1503960366,2016-04-06,11974,27,12,228,1173,1861,39
1503960366,2016-04-07,10198,17,20,195,1208,1755,37
1503960366,2016-04-08,12521,46,22,212,1160,1895,68
1503960366,2016-04-09,12432,32,15,248,738,1883,47
1503960366,2016-04-10,10057,44,13,168,737,1755,57
1503960366,2016-04-11,10990,26,14,216,855,1811,40
1503960366,2016-04-12,224,0,0,9,32,50,0
1624580081,2016-03-25,1810,0,0,121,1319,1373,0
1624580081,2016-03-26,815,0,0,47,1393,1264,0
1624580081,2016-03-27,1985,0,0,112,1328,1350,0
1624580081,2016-03-28,1905,0,0,95,1345,1342,0
1624580081,2016-03-29,1552,0,0,66,1374,1300,0
1624580081,2016-03-30,1675,0,0,84,1356,1313,0
1624580081,2016-03-31,4506,7,4,144,1285,1498,11
1624580081,2016-04-01,9218,0,0,221,1219,1541,0
1624580081,2016-04-02,1556,0,0,88,1352,1327,0
1624580081,2016-04-03,2910,0,0,157,1283,1452,0
1624580081,2016-04-04,18464,0,0,270,1170,1574,0
1624580081,2016-04-05,1335,0,0,74,1366,1308,0
1624580081,2016-04-06,1004,0,0,55,1385,1276,0
1624580081,2016-04-07,1111,0,0,54,1386,1278,0
1624580081,2016-04-08,6344,0,0,143,1297,1409,0
1624580081,2016-04-09,3572,0,0,122,1318,1370,0
1624580081,2016-04-10,3910,7,7,186,1240,1555,14
1624580081,2016-04-11,10000,0,0,172,1268,1469,0
1624580081,2016-04-12,6627,0,0,89,604,706,0
1644430081,2016-04-01,4636,0,16,586,838,3323,16
1644430081,2016-04-02,20237,34,141,347,918,4029,175
1644430081,2016-04-03,12912,59,16,283,1082,3436,75
1644430081,2016-04-04,2819,4,4,87,1345,2444,8
1644430081,2016-04-05,9921,5,35,219,1181,3098,40
1644430081,2016-04-06,8046,18,41,137,1244,2925,59
1644430081,2016-04-07,11166,3,58,230,1149,3202,61
1644430081,2016-04-08,7842,7,43,161,1229,2928,50
1644430081,2016-04-09,13840,18,81,192,1149,3290,99
1644430081,2016-04-10,1329,0,0,35,207,489,0
1844505072,2016-04-01,6847,9,9,251,1171,1969,18
1844505072,2016-04-02,5367,0,0,263,1177,1889,0
1844505072,2016-04-03,2841,0,0,136,1114,1636,0
1844505072,2016-04-04,0,0,0,0,669,1347,0
1844505072,2016-04-05,0,0,0,0,1440,1347,0
1844505072,2016-04-06,7,0,0,1,1439,1349,0
1844505072,2016-04-07,6344,0,0,290,1150,1965,0
1844505072,2016-04-08,5316,0,0,221,1219,1824,0
1844505072,2016-04-09,4979,0,0,184,620,1807,0
1844505072,2016-04-10,6556,0,0,305,810,1971,0
1844505072,2016-04-11,5430,0,0,251,1189,1888,0
1844505072,2016-04-12,0,0,0,0,426,399,0
1927972279,2016-04-01,4317,0,11,192,854,2590,11
1927972279,2016-04-02,5662,0,0,267,858,2783,0
1927972279,2016-04-03,3198,0,0,146,1183,2449,0
1927972279,2016-04-04,2352,0,0,128,829,2380,0
1927972279,2016-04-05,2234,0,0,108,912,2344,0
1927972279,2016-04-06,1259,0,0,73,938,2202,0
1927972279,2016-04-07,768,0,0,43,1397,2130,0
1927972279,2016-04-08,519,0,0,34,1406,2088,0
1927972279,2016-04-09,2523,0,9,134,1250,2443,9
1927972279,2016-04-10,2105,0,0,139,805,2442,0
1927972279,2016-04-11,1209,0,0,73,842,2255,0
1927972279,2016-04-12,24,0,0,3,161,942,0
2022484408,2016-04-01,13603,72,16,213,1139,2645,88
2022484408,2016-04-02,5477,0,0,237,1203,2040,0
2022484408,2016-04-03,11144,25,22,279,1114,2395,47
2022484408,2016-04-04,15313,62,19,233,1126,2581,81
2022484408,2016-04-05,10805,36,37,298,1069,2735,73
2022484408,2016-04-06,15392,47,42,258,1093,2733,89
2022484408,2016-04-07,18247,72,62,252,1054,3021,134
2022484408,2016-04-08,13023,40,12,296,1092,2577,52
2022484408,2016-04-09,16267,44,16,302,1078,2811,60
2022484408,2016-04-10,10005,1,23,339,1077,2458,24
2022484408,2016-04-11,10106,41,16,272,1111,2568,57
2022484408,2016-04-12,6717,41,5,67,551,1140,46
2026352035,2016-04-01,2605,0,0,166,729,1407,0
2026352035,2016-04-02,1229,0,0,69,795,1237,0
2026352035,2016-04-03,2308,0,0,115,720,1330,0
2026352035,2016-04-04,6679,0,0,263,644,1583,0
2026352035,2016-04-05,5645,0,0,248,621,1538,0
2026352035,2016-04-06,3180,0,0,185,738,1421,0
2026352035,2016-04-07,2767,0,0,170,673,1392,0
2026352035,2016-04-08,3762,0,0,173,719,1425,0
2026352035,2016-04-09,3098,0,0,185,700,1413,0
2026352035,2016-04-10,5142,0,0,230,654,1515,0
2026352035,2016-04-11,3279,0,0,164,694,1405,0
2026352035,2016-04-12,1019,0,0,64,223,600,0
2320127002,2016-04-01,0,0,0,0,1440,1324,0
2320127002,2016-04-02,0,0,0,0,1440,1324,0
2320127002,2016-04-03,0,0,0,0,1440,1324,0
2320127002,2016-04-04,0,0,0,0,1440,1324,0
2320127002,2016-04-05,4931,0,0,175,1265,1708,0
2320127002,2016-04-06,6999,0,0,320,1120,1950,0
2320127002,2016-04-07,1846,0,0,93,1347,1508,0
2320127002,2016-04-08,3417,0,0,153,1287,1625,0
2320127002,2016-04-09,4863,1,11,208,1220,1772,12
2320127002,2016-04-10,2277,0,0,103,1337,1530,0
2320127002,2016-04-11,11230,10,2,390,1038,2206,12
2320127002,2016-04-12,2098,0,0,69,617,790,0
2347167796,2016-03-29,10272,2,58,208,700,2041,60
2347167796,2016-03-30,10533,21,35,255,615,2187,56
2347167796,2016-03-31,6760,0,0,250,613,1929,0
2347167796,2016-04-01,8328,0,33,212,804,1935,33
2347167796,2016-04-02,15459,51,16,327,583,2438,67
2347167796,2016-04-03,7485,0,0,324,491,2035,0
2347167796,2016-04-04,10254,21,25,231,638,2099,46
2347167796,2016-04-05,10114,18,9,269,696,2096,27
2347167796,2016-04-06,11107,14,46,196,759,2058,60
2347167796,2016-04-07,10320,15,32,315,1002,2338,47
2347167796,2016-04-08,10209,2,6,316,711,2104,8
2347167796,2016-04-09,16081,16,32,401,970,2488,48
2347167796,2016-04-10,10078,12,3,303,463,2164,15
2347167796,2016-04-11,10001,5,52,196,788,2009,57
2347167796,2016-04-12,0,0,0,0,425,399,0
2873212765,2016-04-01,890,0,0,41,1399,1335,0
2873212765,2016-04-02,2214,0,0,197,1243,1559,0
2873212765,2016-04-03,7640,3,15,315,1107,1845,18
2873212765,2016-04-04,9713,6,24,355,1055,2046,30
2873212765,2016-04-05,8432,0,0,374,1066,1953,0
2873212765,2016-04-06,7350,0,0,382,1058,1910,0
2873212765,2016-04-07,9353,5,17,363,1055,2035,22
2873212765,2016-04-08,7157,0,0,380,1060,1944,0
2873212765,2016-04-09,14103,46,8,288,1098,2257,54
2873212765,2016-04-10,5290,1,8,251,1180,1724,9
2873212765,2016-04-11,7497,0,0,357,882,1741,0
2873212765,2016-04-12,0,0,0,0,1440,0,0
2891001357,2016-03-29,0,0,0,0,1440,1920,0
2891001357,2016-03-30,0,0,0,0,1440,1920,0
2891001357,2016-03-31,0,0,0,0,1440,1920,0
2891001357,2016-04-02,4126,0,0,720,720,2881,0
2891001357,2016-04-03,0,0,0,0,1440,1920,0
2891001357,2016-04-04,0,0,0,0,1440,1920,0
2891001357,2016-04-05,2063,0,0,630,99,1144,0
3372868164,2016-04-01,5785,0,0,311,1129,1852,0
3372868164,2016-04-02,7625,24,1,341,1074,2069,25
3372868164,2016-04-03,4706,0,0,299,1141,1816,0
3372868164,2016-04-04,5861,20,7,233,1180,1878,27
3372868164,2016-04-05,4460,0,0,248,1192,1787,0
3372868164,2016-04-06,6406,17,4,325,1094,2010,21
3372868164,2016-04-07,7392,14,9,332,1085,2038,23
3372868164,2016-04-08,5551,0,0,282,1158,1815,0
3372868164,2016-04-09,8827,21,10,346,1063,2062,31
3372868164,2016-04-10,4662,22,4,152,735,1276,26
3977333714,2016-04-01,4499,0,0,168,842,1288,0
3977333714,2016-04-02,7618,0,6,302,842,1490,6
3977333714,2016-04-03,11508,29,22,282,748,1630,51
3977333714,2016-04-04,11943,16,43,297,710,1648,59
3977333714,2016-04-05,12303,26,32,291,605,1649,58
3977333714,2016-04-06,15425,24,45,331,614,1783,69
3977333714,2016-04-07,8422,0,81,139,815,1431,81
3977333714,2016-04-08,10226,0,101,174,685,1524,101
3977333714,2016-04-09,14583,35,36,254,697,1697,71
3977333714,2016-04-10,3573,15,8,99,866,1232,23
3977333714,2016-04-11,3108,1,1,129,894,1223,2
3977333714,2016-04-12,759,0,0,17,187,182,0
4020332650,2016-03-12,5543,0,0,254,757,2990,0
4020332650,2016-03-13,3226,0,0,136,771,2480,0
4020332650,2016-03-14,3023,0,0,145,1005,2570,0
4020332650,2016-03-15,5906,0,10,215,874,3016,10
4020332650,2016-03-16,12483,25,14,309,599,3830,39
4020332650,2016-03-17,8940,0,0,47,986,3706,0
4020332650,2016-03-18,368,0,0,0,1440,2024,0
4020332650,2016-03-19,5702,0,0,0,1440,2980,0
4020332650,2016-03-20,10330,0,0,0,1440,3728,0
4020332650,2016-03-21,8778,0,0,0,1440,3348,0
4020332650,2016-03-22,6662,0,0,0,1440,3162,0
4020332650,2016-03-23,6309,0,0,0,1440,3140,0
4020332650,2016-03-24,1951,0,0,0,1440,1980,0
4020332650,2016-03-25,5563,0,0,0,1440,3681,0
4020332650,2016-03-26,4370,0,0,0,1440,3444,0
4020332650,2016-03-27,7144,0,0,0,1440,3510,0
4020332650,2016-03-28,2106,31,45,75,1289,4010,76
4020332650,2016-03-29,4152,0,0,187,1253,2976,0
4020332650,2016-03-30,5400,0,0,258,795,3418,0
4020332650,2016-03-31,7428,18,33,261,860,3439,51
4020332650,2016-04-01,5351,15,17,210,748,3338,32
4020332650,2016-04-02,4299,3,15,162,752,2892,18
4020332650,2016-04-03,6107,0,0,265,776,3313,0
4020332650,2016-04-04,6429,0,28,193,741,3118,28
4020332650,2016-04-05,6880,7,19,165,1249,2966,26
4020332650,2016-04-06,7476,0,0,263,920,3253,0
4020332650,2016-04-07,6581,0,8,241,1191,3032,8
4020332650,2016-04-08,10480,6,37,272,1125,4034,43
4020332650,2016-04-09,7734,20,12,223,1185,3264,32
4020332650,2016-04-10,5129,5,7,176,1178,2817,12
4020332650,2016-04-11,2993,0,0,114,888,2507,0
4020332650,2016-04-12,8,0,0,1,321,446,0
4057192912,2016-03-12,0,0,0,0,1440,1777,0
4057192912,2016-03-13,0,0,0,0,1440,1777,0
4057192912,2016-03-14,8433,30,7,135,1268,2453,37
4057192912,2016-03-15,0,0,0,0,1440,1776,0
4057192912,2016-03-16,2139,0,28,15,1397,1935,28
4057192912,2016-03-17,0,0,0,0,1440,1776,0
4057192912,2016-03-18,949,0,0,34,1406,1870,0
4057192912,2016-03-19,0,0,0,0,1440,1777,0
4057192912,2016-03-20,44,0,0,2,1438,1782,0
4057192912,2016-03-21,2660,0,0,46,1394,1978,0
4057192912,2016-03-22,5561,0,0,169,1271,2296,0
4057192912,2016-03-23,7239,7,7,190,1236,2484,14
4057192912,2016-03-24,7,0,0,1,1439,1787,0
4057192912,2016-03-25,0,0,0,0,1440,1776,0
4057192912,2016-03-26,0,0,0,0,1440,1776,0
4057192912,2016-03-27,2275,0,0,86,1354,2005,0
4057192912,2016-03-28,8,0,0,1,1439,1778,0
4057192912,2016-03-29,5137,0,0,160,1280,2293,0
4057192912,2016-03-30,5419,0,0,145,1295,2259,0
4057192912,2016-03-31,0,0,0,0,1440,1776,0
4057192912,2016-04-01,0,0,0,0,1440,1776,0
4057192912,2016-04-02,0,0,0,0,1440,1776,0
4057192912,2016-04-03,0,0,0,0,1440,1776,0
4057192912,2016-04-04,0,0,0,0,1440,1776,0
4057192912,2016-04-05,0,0,0,0,1440,1776,0
4057192912,2016-04-06,18,0,0,2,1438,1780,0
4057192912,2016-04-07,4,0,0,1,1439,1778,0
4057192912,2016-04-08,8426,2,120,25,1293,2360,122
4057192912,2016-04-09,1650,0,0,60,1380,1952,0
4057192912,2016-04-10,3434,1,7,108,1324,2101,8
4057192912,2016-04-11,6801,0,0,193,1247,2393,0
4057192912,2016-04-12,187,0,0,11,400,538,0
4319703577,2016-03-29,5643,3,8,199,683,1958,11
4319703577,2016-03-30,9043,4,12,244,702,2141,16
4319703577,2016-03-31,8144,4,17,247,1125,2129,21
4319703577,2016-04-01,9343,14,20,268,654,2216,34
4319703577,2016-04-02,8405,15,4,257,621,2154,19
4319703577,2016-04-03,8223,12,37,257,551,2178,49
4319703577,2016-04-04,10067,5,39,313,578,2308,44
4319703577,2016-04-05,8359,3,14,311,638,2201,17
4319703577,2016-04-06,10946,8,51,308,569,2341,59
4319703577,2016-04-07,9130,7,11,304,668,2236,18
4319703577,2016-04-08,6544,4,6,276,1132,2069,10
4319703577,2016-04-09,0,0,0,0,1440,0,0
4388161847,2016-03-29,0,0,0,0,1440,1878,0
4388161847,2016-03-30,0,0,0,0,1440,1878,0
4388161847,2016-03-31,0,0,0,0,1440,1878,0
4388161847,2016-04-01,0,0,0,0,1440,1878,0
4388161847,2016-04-02,0,0,0,0,1440,1878,0
4388161847,2016-04-03,0,0,0,0,1440,1878,0
4388161847,2016-04-04,0,0,0,0,1440,1878,0
4388161847,2016-04-05,0,0,0,0,994,1296,0
4445114986,2016-03-29,2303,0,0,155,807,2010,0
4445114986,2016-03-30,2600,0,0,163,1277,2032,0
4445114986,2016-03-31,4804,0,0,238,786,2227,0
4445114986,2016-04-01,3271,0,0,205,898,2133,0
4445114986,2016-04-02,5406,0,0,273,672,2317,0
4445114986,2016-04-03,3146,0,0,171,1269,2058,0
4445114986,2016-04-04,2422,0,0,110,1330,1935,0
4445114986,2016-04-05,4239,1,6,235,702,2217,7
4445114986,2016-04-06,6911,28,2,215,745,2374,30
4445114986,2016-04-07,6667,24,1,208,939,2335,25
4445114986,2016-04-08,5543,0,0,266,941,2303,0
4445114986,2016-04-09,4195,0,0,239,758,2210,0
4445114986,2016-04-10,6625,0,0,316,755,2424,0
4445114986,2016-04-11,5986,23,5,195,789,2297,28
4445114986,2016-04-12,278,0,0,20,253,745,0
4558609924,2016-04-01,5336,0,0,258,1182,1902,0
4558609924,2016-04-02,3183,0,0,173,1180,1680,0
4558609924,2016-04-03,6176,1,7,269,886,1901,8
4558609924,2016-04-04,8205,0,0,367,1073,2078,0
4558609924,2016-04-05,6799,24,14,185,1217,1876,38
4558609924,2016-04-06,5668,0,0,259,1181,1853,0
4558609924,2016-04-07,7998,27,12,296,1105,2235,39
4558609924,2016-04-08,4195,0,0,241,1199,1778,0
4558609924,2016-04-09,5512,0,0,276,1164,1882,0
4558609924,2016-04-10,6263,0,0,290,1150,1906,0
4558609924,2016-04-11,8828,0,0,308,1132,2149,0
4558609924,2016-04-12,1260,0,0,76,555,722,0
4702921684,2016-03-29,6506,4,5,241,760,2886,9
4702921684,2016-03-30,7583,3,13,227,742,2915,16
4702921684,2016-03-31,6963,0,0,256,759,2895,0
4702921684,2016-04-01,7165,0,9,248,708,2923,9
4702921684,2016-04-02,10328,0,32,367,475,3323,32
4702921684,2016-04-03,12116,3,57,323,471,3357,60
4702921684,2016-04-04,7810,6,27,216,746,2931,33
4702921684,2016-04-05,6670,15,16,199,770,2848,31
4702921684,2016-04-06,7605,4,4,248,708,2943,8
4702921684,2016-04-07,6585,0,0,210,770,2822,0
4702921684,2016-04-08,8184,0,15,247,808,2981,15
4702921684,2016-04-09,14002,8,56,381,407,3597,64
4702921684,2016-04-10,11135,1,25,331,528,3224,26
4702921684,2016-04-11,6499,0,0,207,809,2677,0
4702921684,2016-04-12,0,0,0,0,1440,0,0
5553957443,2016-04-01,12409,51,12,235,782,2142,63
5553957443,2016-04-02,2937,0,0,181,356,1615,0
5553957443,2016-04-03,1515,0,0,93,507,1481,0
5553957443,2016-04-04,8921,27,8,198,754,1892,35
5553957443,2016-04-05,11306,40,26,218,772,2086,66
5553957443,2016-04-06,12252,33,28,229,745,2044,61
5553957443,2016-04-07,15444,51,39,243,731,2249,90
5553957443,2016-04-08,9938,38,24,193,767,2019,62
5553957443,2016-04-09,4599,0,0,176,578,1692,0
5553957443,2016-04-10,5594,4,25,150,552,1712,29
5553957443,2016-04-11,11906,32,27,234,688,2065,59
5553957443,2016-04-12,3436,7,11,50,61,633,18
5577150313,2016-04-01,10461,99,31,142,721,3625,130
5577150313,2016-04-02,14873,202,36,153,663,4430,238
5577150313,2016-04-03,9917,58,27,240,700,3427,85
5577150313,2016-04-04,7401,70,19,204,689,3492,89
5577150313,2016-04-05,8964,107,18,145,756,3597,125
5577150313,2016-04-06,11080,83,52,190,695,3765,135
5577150313,2016-04-07,4499,31,11,146,756,2775,42
5577150313,2016-04-08,4363,8,2,156,813,2486,10
5577150313,2016-04-09,10494,123,62,138,601,3817,185
5577150313,2016-04-10,9776,80,35,162,721,3378,115
5577150313,2016-04-11,2862,39,17,54,209,1511,56
6117666160,2016-04-01,7444,0,0,286,568,2210,0
6117666160,2016-04-02,19658,3,30,475,466,2884,33
6117666160,2016-04-03,0,0,0,0,1440,1496,0
6117666160,2016-04-04,8468,2,11,279,1148,2262,13
6117666160,2016-04-05,9910,0,0,384,990,2445,0
6117666160,2016-04-06,12409,0,0,491,388,2694,0
6117666160,2016-04-07,4853,0,0,156,770,1903,0
6117666160,2016-04-08,8955,0,0,422,1018,2482,0
6117666160,2016-04-09,10789,0,0,506,413,2617,0
6117666160,2016-04-10,0,0,0,0,1440,0,0
6290855005,2016-04-01,6633,0,0,280,1160,2778,0
6290855005,2016-04-02,9548,25,107,113,1195,3119,132
6290855005,2016-04-03,0,33,0,0,1407,2664,33
6290855005,2016-04-04,0,0,0,0,1440,2060,0
6290855005,2016-04-05,0,0,0,0,1440,2060,0
6290855005,2016-04-06,0,0,0,0,1440,2060,0
6290855005,2016-04-07,0,0,0,0,1440,2060,0
6290855005,2016-04-08,0,0,0,0,1440,2060,0
6290855005,2016-04-09,0,0,0,0,1440,2060,0
6290855005,2016-04-10,0,20,0,0,494,735,20
6391747486,2016-04-01,0,0,0,0,1440,1820,0
6391747486,2016-04-02,2101,46,0,0,1394,2224,46
6391747486,2016-04-03,0,0,0,0,1440,1820,0
6391747486,2016-04-04,0,0,0,0,1440,1820,0
6391747486,2016-04-05,9766,0,6,301,1133,2442,6
6391747486,2016-04-06,165,0,0,8,1432,1849,0
6391747486,2016-04-07,0,0,0,0,1440,1822,0
6391747486,2016-04-08,0,0,0,0,1440,1820,0
6391747486,2016-04-09,0,0,0,0,198,251,0
6775888955,2016-04-01,7225,25,50,163,1189,3065,75
6775888955,2016-04-02,1988,0,0,79,909,2207,0
6775888955,2016-04-03,1577,1,17,8,1414,1977,18
6775888955,2016-04-04,0,0,0,0,1440,1841,0
6775888955,2016-04-05,9348,56,133,240,1011,4286,189
6775888955,2016-04-06,11761,24,99,300,550,3920,123
6775888955,2016-04-07,13987,46,114,250,739,3856,160
6775888955,2016-04-08,4131,27,30,75,1308,2584,57
6775888955,2016-04-09,14,0,0,1,601,787,0
6962181067,2016-03-30,15491,18,77,272,641,2244,95
6962181067,2016-03-31,14097,50,32,234,595,2188,82
6962181067,2016-04-01,10467,9,45,252,602,2014,54
6962181067,2016-04-02,12437,50,24,219,732,2115,74
6962181067,2016-04-03,12307,14,51,218,589,2055,65
6962181067,2016-04-04,18952,73,20,327,570,2437,93
6962181067,2016-04-05,12010,38,17,287,692,2158,55
6962181067,2016-04-06,12480,55,14,276,593,2170,69
6962181067,2016-04-07,13417,45,16,284,665,2244,61
6962181067,2016-04-08,14400,27,37,276,697,2188,64
6962181067,2016-04-09,12495,33,19,324,609,2231,52
6962181067,2016-04-10,10148,19,7,306,679,2100,26
6962181067,2016-04-11,12362,21,38,297,678,2188,59
6962181067,2016-04-12,5893,43,9,48,146,917,52
7007744171,2016-04-01,11680,50,7,244,1139,2573,57
7007744171,2016-04-02,10976,9,16,271,1075,2575,25
7007744171,2016-04-03,16806,104,31,230,1002,3086,135
7007744171,2016-04-04,15266,70,21,292,1057,2886,91
7007744171,2016-04-05,12084,50,6,284,1030,2676,56
7007744171,2016-04-06,13513,64,8,270,1098,2811,72
7007744171,2016-04-07,14100,61,33,265,1015,2840,94
7007744171,2016-04-08,12627,54,22,301,1063,2871,76
7007744171,2016-04-09,10345,2,6,358,1074,2613,8
7007744171,2016-04-10,10146,1,12,397,1030,2700,13
7007744171,2016-04-11,12168,18,27,375,1020,2871,45
7007744171,2016-04-12,7413,53,6,43,405,1023,59
7086361926,2016-04-01,11463,38,30,154,777,2496,68
7086361926,2016-04-02,87,0,0,2,872,1641,0
7086361926,2016-04-03,1949,3,6,27,1404,1794,9
7086361926,2016-04-04,6101,31,24,138,1247,2421,55
7086361926,2016-04-05,7478,25,33,132,1159,2439,58
7086361926,2016-04-06,7352,19,14,124,814,2233,33
7086361926,2016-04-07,14604,76,30,127,695,2862,106
7086361926,2016-04-08,9634,50,48,140,797,2752,98
7086361926,2016-04-09,7338,27,5,204,717,2519,32
7086361926,2016-04-10,569,0,0,27,1368,1799,0
7086361926,2016-04-11,6242,46,22,126,741,2543,68
7086361926,2016-04-12,430,0,0,14,75,625,0
8053475328,2016-04-02,20188,124,19,172,1125,3377,143
8053475328,2016-04-03,25701,165,36,97,1142,3697,201
8053475328,2016-04-04,17395,100,4,213,1123,3209,104
8053475328,2016-04-05,17167,98,8,184,1150,3167,106
8053475328,2016-04-06,16435,100,14,191,1135,3122,114
8053475328,2016-04-07,17078,101,6,190,1143,3176,107
8053475328,2016-04-08,11693,60,6,153,1221,2790,66
8053475328,2016-04-09,11159,59,6,120,1255,2715,65
8053475328,2016-04-10,10118,30,18,207,1185,2684,48
8053475328,2016-04-11,16064,96,8,155,1181,3097,104
8053475328,2016-04-12,290,0,0,16,599,791,0
8253242879,2016-04-01,0,0,0,0,1440,1429,0
8253242879,2016-04-02,0,0,0,0,1440,1429,0
8253242879,2016-04-03,0,0,0,0,1440,1429,0
8253242879,2016-04-04,0,0,0,0,1440,1429,0
8253242879,2016-04-05,0,0,0,0,1440,1429,0
8253242879,2016-04-06,1931,0,0,94,1346,1607,0
8253242879,2016-04-07,5181,15,15,107,1303,1776,30
8253242879,2016-04-08,12026,47,13,150,1230,2162,60
8253242879,2016-04-09,5360,8,28,148,1256,1832,36
8253242879,2016-04-10,2545,0,0,126,1314,1657,0
8253242879,2016-04-11,1636,0,0,86,1139,1377,0
8253242879,2016-04-12,0,0,0,0,1440,0,0
8378563200,2016-04-01,14179,73,21,195,719,3669,94
8378563200,2016-04-02,3358,0,0,144,657,2702,0
8378563200,2016-04-03,9152,25,13,243,600,3304,38
8378563200,2016-04-04,13935,105,16,220,658,4234,121
8378563200,2016-04-05,12846,113,15,189,686,4128,128
8378563200,2016-04-06,9124,55,6,230,728,3798,61
8378563200,2016-04-07,9725,83,11,181,670,3839,94
8378563200,2016-04-08,8350,72,10,167,868,3713,82
8378563200,2016-04-09,2240,0,0,110,843,2606,0
8378563200,2016-04-10,2631,0,0,117,727,2624,0
8378563200,2016-04-11,8837,74,17,182,811,3775,91
8378563200,2016-04-12,3246,65,15,49,243,1882,80
8583815059,2016-04-01,2174,0,0,112,1328,2360,0
8583815059,2016-04-02,3494,0,0,166,1274,2517,0
8583815059,2016-04-03,2380,0,0,131,1309,2400,0
8583815059,2016-04-04,3159,0,0,147,1293,2462,0
8583815059,2016-04-05,6835,5,15,212,1208,2786,20
8583815059,2016-04-06,2098,0,0,112,1328,2354,0
8583815059,2016-04-07,2816,0,0,138,1302,2437,0
8583815059,2016-04-08,1408,0,0,79,1052,1814,0
8792009665,2016-04-01,4592,4,8,176,748,2260,12
8792009665,2016-04-02,8452,9,24,328,1079,3004,33
8792009665,2016-04-03,7238,2,6,279,636,2667,8
8792009665,2016-04-04,3821,0,9,161,675,2229,9
8792009665,2016-04-05,2332,1,10,111,904,2100,11
8792009665,2016-04-06,2121,0,0,122,855,2114,0
8792009665,2016-04-07,1291,0,0,77,888,1961,0
8792009665,2016-04-08,1467,2,8,71,912,1953,10
8792009665,2016-04-09,1022,0,0,63,739,1890,0
8792009665,2016-04-10,4605,0,0,179,1261,2253,0
8792009665,2016-04-11,178,0,0,12,1428,1725,0
8792009665,2016-04-12,20,0,0,6,598,728,0
8877689391,2016-04-01,18700,67,3,247,1123,3527,70
8877689391,2016-04-02,27572,116,24,260,1040,4220,140
8877689391,2016-04-03,15260,106,17,259,1058,3864,123
8877689391,2016-04-04,20779,78,16,208,1138,3662,94
8877689391,2016-04-05,10695,10,3,246,1181,2834,13
8877689391,2016-04-06,24136,87,16,318,1019,4039,103
8877689391,2016-04-07,10910,32,11,212,1185,2947,43
8877689391,2016-04-08,23014,70,29,359,982,4196,99
8877689391,2016-04-09,16470,90,9,289,1052,3841,99
8877689391,2016-04-10,28497,128,46,211,1055,4526,174
8877689391,2016-04-11,10622,18,7,225,1190,2820,25
8877689391,2016-04-12,2350,0,0,58,531,938,0
1503960366,2016-04-12,13162,25,13,328,728,1985,38
1503960366,2016-04-13,10735,21,19,217,776,1797,40
1503960366,2016-04-14,10460,30,11,181,1218,1776,41
1503960366,2016-04-15,9762,29,34,209,726,1745,63
1503960366,2016-04-16,12669,36,10,221,773,1863,46
1503960366,2016-04-17,9705,38,20,164,539,1728,58
1503960366,2016-04-18,13019,42,16,233,1149,1921,58
1503960366,2016-04-19,15506,50,31,264,775,2035,81
1503960366,2016-04-20,10544,28,12,205,818,1786,40
1503960366,2016-04-21,9819,19,8,211,838,1775,27
1503960366,2016-04-22,12764,66,27,130,1217,1827,93
1503960366,2016-04-23,14371,41,21,262,732,1949,62
1503960366,2016-04-24,10039,39,5,238,709,1788,44
1503960366,2016-04-25,15355,73,14,216,814,2013,87
1503960366,2016-04-26,13755,31,23,279,833,1970,54
1503960366,2016-04-27,18134,78,11,243,1108,2159,89
1503960366,2016-04-28,13154,48,28,189,782,1898,76
1503960366,2016-04-29,11181,16,12,243,815,1837,28
1503960366,2016-04-30,14673,52,34,217,712,1947,86
1503960366,2016-05-01,10602,33,35,246,730,1820,68
1503960366,2016-05-02,14727,41,15,277,798,2004,56
1503960366,2016-05-03,15103,50,24,254,816,1990,74
1503960366,2016-05-04,11100,36,22,203,1179,1819,58
1503960366,2016-05-05,14070,45,24,250,857,1959,69
1503960366,2016-05-06,12159,24,6,289,754,1896,30
1503960366,2016-05-07,11992,37,46,175,833,1821,83
1503960366,2016-05-08,10060,44,8,203,574,1740,52
1503960366,2016-05-09,12022,46,11,206,835,1819,57
1503960366,2016-05-10,12207,46,31,214,746,1859,77
1503960366,2016-05-11,12770,36,23,251,669,1783,59
1503960366,2016-05-12,0,0,0,0,1440,0,0
1624580081,2016-04-12,8163,0,0,146,1294,1432,0
1624580081,2016-04-13,7007,0,0,148,1292,1411,0
1624580081,2016-04-14,9107,0,0,236,1204,1572,0
1624580081,2016-04-15,1510,0,0,96,1344,1344,0
1624580081,2016-04-16,5370,0,0,176,1264,1463,0
1624580081,2016-04-17,6175,15,22,127,1276,1554,37
1624580081,2016-04-18,10536,17,7,202,1214,1604,24
1624580081,2016-04-19,2916,0,0,141,1299,1435,0
1624580081,2016-04-20,4974,0,0,151,1289,1446,0
1624580081,2016-04-21,6349,0,0,186,1254,1467,0
1624580081,2016-04-22,4026,0,0,199,1241,1470,0
1624580081,2016-04-23,8538,0,0,227,1213,1562,0
1624580081,2016-04-24,6076,16,18,185,1221,1617,34
1624580081,2016-04-25,6497,0,0,202,1238,1492,0
1624580081,2016-04-26,2826,0,0,140,1300,1402,0
1624580081,2016-04-27,8367,17,36,154,1233,1670,53
1624580081,2016-04-28,2759,0,5,115,1320,1401,5
1624580081,2016-04-29,2390,0,0,150,1290,1404,0
1624580081,2016-04-30,6474,11,23,224,1182,1655,34
1624580081,2016-05-01,36019,186,63,171,1020,2690,249
1624580081,2016-05-02,7155,7,6,166,1261,1497,13
1624580081,2016-05-03,2100,0,0,96,1344,1334,0
1624580081,2016-05-04,2193,0,0,118,1322,1368,0
1624580081,2016-05-05,2470,0,0,117,1323,1370,0
1624580081,2016-05-06,1727,0,0,102,1338,1341,0
1624580081,2016-05-07,2104,0,0,182,1258,1474,0
1624580081,2016-05-08,3427,0,0,152,1288,1427,0
1624580081,2016-05-09,1732,0,0,91,1349,1328,0
1624580081,2016-05-10,2969,0,0,139,1301,1393,0
1624580081,2016-05-11,3134,0,0,112,1328,1359,0
1624580081,2016-05-12,2971,0,0,107,890,1002,0
1644430081,2016-04-12,10694,2,51,256,1131,3199,53
1644430081,2016-04-13,8001,30,16,135,1259,2902,46
1644430081,2016-04-14,11037,5,58,252,1125,3226,63
1644430081,2016-04-15,5263,3,4,170,1263,2750,7
1644430081,2016-04-16,15300,51,42,212,1135,3493,93
1644430081,2016-04-17,8757,29,13,186,1212,3011,42
1644430081,2016-04-18,7132,15,33,121,1271,2806,48
1644430081,2016-04-19,11256,5,58,278,1099,3300,63
1644430081,2016-04-20,2436,0,0,125,1315,2430,0
1644430081,2016-04-21,1223,0,0,38,1402,2140,0
1644430081,2016-04-22,3673,0,0,86,1354,2344,0
1644430081,2016-04-23,6637,0,15,160,1265,2677,15
1644430081,2016-04-24,3321,0,0,89,1351,2413,0
1644430081,2016-04-25,3580,8,1,94,1337,2497,9
1644430081,2016-04-26,9919,11,41,223,1165,3123,52
1644430081,2016-04-27,3032,0,0,118,1322,2489,0
1644430081,2016-04-28,9405,3,53,227,1157,3108,56
1644430081,2016-04-29,3176,0,0,120,1193,2498,0
1644430081,2016-04-30,18213,9,71,402,816,3846,80
1644430081,2016-05-01,6132,3,24,146,908,2696,27
1644430081,2016-05-02,3758,1,7,148,682,2580,8
1644430081,2016-05-03,12850,10,94,221,1115,3324,104
1644430081,2016-05-04,2309,0,0,52,1388,2222,0
1644430081,2016-05-05,4363,6,12,81,1341,2463,18
1644430081,2016-05-06,9787,11,6,369,1054,3328,17
1644430081,2016-05-07,13372,41,17,243,1139,3404,58
1644430081,2016-05-08,6724,0,0,295,991,2987,0
1644430081,2016-05-09,6643,32,6,303,1099,3008,38
1644430081,2016-05-10,9167,12,19,155,1254,2799,31
1644430081,2016-05-11,1329,0,0,49,713,1276,0
1844505072,2016-04-12,6697,0,0,339,1101,2030,0
1844505072,2016-04-13,4929,0,0,248,1192,1860,0
1844505072,2016-04-14,7937,0,0,373,843,2130,0
1844505072,2016-04-15,3844,0,0,176,527,1725,0
1844505072,2016-04-16,3414,0,0,147,1293,1657,0
1844505072,2016-04-17,4525,2,8,199,1231,1793,10
1844505072,2016-04-18,4597,0,12,217,1211,1814,12
1844505072,2016-04-19,197,0,0,10,1430,1366,0
1844505072,2016-04-20,8,0,0,1,1439,1349,0
1844505072,2016-04-21,8054,2,13,308,1117,2062,15
1844505072,2016-04-22,5372,0,0,220,1220,1827,0
1844505072,2016-04-23,3570,0,0,139,1301,1645,0
1844505072,2016-04-24,0,0,0,0,1440,1347,0
1844505072,2016-04-25,0,0,0,0,1440,1347,0
1844505072,2016-04-26,0,0,0,0,1440,1347,0
1844505072,2016-04-27,4,0,0,1,1439,1348,0
1844505072,2016-04-28,6907,0,0,302,1138,1992,0
1844505072,2016-04-29,4920,0,0,247,1082,1856,0
1844505072,2016-04-30,4014,0,0,184,218,1763,0
1844505072,2016-05-01,2573,0,7,75,585,1541,7
1844505072,2016-05-02,0,0,0,0,1440,1348,0
1844505072,2016-05-03,4059,0,0,184,1256,1742,0
1844505072,2016-05-04,2080,0,0,87,1353,1549,0
1844505072,2016-05-05,2237,0,0,120,1320,1589,0
1844505072,2016-05-06,44,0,0,2,1438,1351,0
1844505072,2016-05-07,0,0,0,0,1440,1347,0
1844505072,2016-05-08,0,0,0,0,1440,1347,0
1844505072,2016-05-09,0,0,0,0,1440,1347,0
1844505072,2016-05-10,0,0,0,0,1440,1347,0
1844505072,2016-05-11,0,0,0,0,1440,1347,0
1844505072,2016-05-12,0,0,0,0,711,665,0
1927972279,2016-04-12,678,0,0,55,734,2220,0
1927972279,2016-04-13,356,0,0,32,986,2151,0
1927972279,2016-04-14,2163,0,9,88,1292,2383,9
1927972279,2016-04-15,980,0,0,51,941,2221,0
1927972279,2016-04-16,0,0,0,0,1440,2064,0
1927972279,2016-04-17,0,0,0,0,1440,2063,0
1927972279,2016-04-18,244,0,0,17,1423,2111,0
1927972279,2016-04-19,0,0,0,0,1440,2063,0
1927972279,2016-04-20,0,0,0,0,1440,2063,0
1927972279,2016-04-21,0,0,0,0,1440,2064,0
1927972279,2016-04-22,149,0,0,10,1430,2093,0
1927972279,2016-04-23,2945,0,0,145,1295,2499,0
1927972279,2016-04-24,2090,1,6,75,1358,2324,7
1927972279,2016-04-25,152,0,0,12,1303,2100,0
1927972279,2016-04-26,3761,0,0,192,1058,2638,0
1927972279,2016-04-27,0,0,0,0,1440,2063,0
1927972279,2016-04-28,1675,0,0,95,1167,2351,0
1927972279,2016-04-29,0,0,0,0,1440,2063,0
1927972279,2016-04-30,0,0,0,0,1440,2064,0
1927972279,2016-05-01,2704,14,1,70,1355,2411,15
1927972279,2016-05-02,3790,16,8,94,1322,2505,24
1927972279,2016-05-03,1326,10,0,17,1413,2195,10
1927972279,2016-05-04,1786,0,0,87,1353,2338,0
1927972279,2016-05-05,0,0,0,0,1440,2063,0
1927972279,2016-05-06,2091,0,0,108,1332,2383,0
1927972279,2016-05-07,1510,0,0,48,1392,2229,0
1927972279,2016-05-08,0,0,0,0,1440,2063,0
1927972279,2016-05-09,0,0,0,0,1440,2063,0
1927972279,2016-05-10,0,0,0,0,1440,2063,0
1927972279,2016-05-11,0,0,0,0,1440,2063,0
1927972279,2016-05-12,0,0,0,0,966,1383,0
2022484408,2016-04-12,11875,42,14,227,1157,2390,56
2022484408,2016-04-13,12024,43,5,292,1100,2601,48
2022484408,2016-04-14,10690,32,3,257,1148,2312,35
2022484408,2016-04-15,11034,27,9,282,1122,2525,36
2022484408,2016-04-16,10100,41,11,151,1237,2177,52
2022484408,2016-04-17,15112,28,29,331,1052,2782,57
2022484408,2016-04-18,14131,48,3,311,1078,2770,51
2022484408,2016-04-19,11548,31,7,250,1152,2489,38
2022484408,2016-04-20,15112,48,63,276,1053,2897,111
2022484408,2016-04-21,12453,104,53,255,1028,3158,157
2022484408,2016-04-22,12954,52,10,273,1105,2638,62
2022484408,2016-04-23,6001,0,0,249,1191,2069,0
2022484408,2016-04-24,13481,37,26,216,1161,2529,63
2022484408,2016-04-25,11369,44,8,217,1171,2470,52
2022484408,2016-04-26,10119,55,24,275,1086,2793,79
2022484408,2016-04-27,10159,19,20,282,1119,2463,39
2022484408,2016-04-28,10140,6,20,291,1123,2296,26
2022484408,2016-04-29,10245,21,40,281,1098,2611,61
2022484408,2016-04-30,18387,13,23,361,1043,2732,36
2022484408,2016-05-01,10538,25,28,245,1142,2380,53
2022484408,2016-05-02,10379,36,8,277,1119,2473,44
2022484408,2016-05-03,12183,72,14,250,1104,2752,86
2022484408,2016-05-04,11768,36,27,272,1105,2649,63
2022484408,2016-05-05,11895,55,20,253,1112,2609,75
2022484408,2016-05-06,10227,24,17,295,1104,2498,41
2022484408,2016-05-07,6708,20,2,149,1269,1995,22
2022484408,2016-05-08,3292,0,0,135,1305,1848,0
2022484408,2016-05-09,13379,35,47,297,1061,2709,82
2022484408,2016-05-10,12798,57,28,271,1084,2797,85
2022484408,2016-05-11,13272,58,25,224,1133,2544,83
2022484408,2016-05-12,9117,16,16,236,728,1853,32
2026352035,2016-04-12,4414,3,8,181,706,1459,11
2026352035,2016-04-13,4993,0,0,238,663,1521,0
2026352035,2016-04-14,3335,0,0,197,653,1431,0
2026352035,2016-04-15,3821,0,0,188,687,1444,0
2026352035,2016-04-16,2547,0,0,150,728,1373,0
2026352035,2016-04-17,838,0,0,60,1053,1214,0
2026352035,2016-04-18,3325,0,0,182,1062,1419,0
2026352035,2016-04-19,2424,0,0,141,785,1356,0
2026352035,2016-04-20,7222,0,0,327,623,1667,0
2026352035,2016-04-21,2467,0,0,153,749,1370,0
2026352035,2016-04-22,2915,0,0,162,712,1399,0
2026352035,2016-04-23,12357,0,0,432,458,1916,0
2026352035,2016-04-24,3490,0,0,164,704,1401,0
2026352035,2016-04-25,6017,0,0,260,821,1576,0
2026352035,2016-04-26,5933,0,0,288,1018,1595,0
2026352035,2016-04-27,6088,0,0,286,586,1593,0
2026352035,2016-04-28,6375,0,0,331,626,1649,0
2026352035,2016-04-29,7604,0,0,352,492,1692,0
2026352035,2016-04-30,4729,0,0,233,594,1506,0
2026352035,2016-05-01,3609,0,0,191,716,1447,0
2026352035,2016-05-02,7018,0,0,355,716,1690,0
2026352035,2016-05-03,5992,0,0,304,981,1604,0
2026352035,2016-05-04,6564,0,0,345,530,1658,0
2026352035,2016-05-05,12167,0,0,475,479,1926,0
2026352035,2016-05-06,8198,0,0,383,511,1736,0
2026352035,2016-05-07,4193,0,0,229,665,1491,0
2026352035,2016-05-08,5528,0,0,258,610,1555,0
2026352035,2016-05-09,10685,0,0,401,543,1869,0
2026352035,2016-05-10,254,0,0,17,1002,1141,0
2026352035,2016-05-11,8580,0,0,330,569,1698,0
2026352035,2016-05-12,8891,0,0,343,330,1364,0
2320127002,2016-04-12,10725,13,9,306,1112,2124,22
2320127002,2016-04-13,7275,0,0,335,1105,2003,0
2320127002,2016-04-14,3973,0,0,191,1249,1696,0
2320127002,2016-04-15,5205,0,0,245,1195,1801,0
2320127002,2016-04-16,5057,0,0,195,1245,1724,0
2320127002,2016-04-17,6198,0,0,249,1191,1852,0
2320127002,2016-04-18,6559,0,7,260,1173,1905,7
2320127002,2016-04-19,5997,0,11,228,1201,1811,11
2320127002,2016-04-20,7192,0,11,283,1146,1922,11
2320127002,2016-04-21,3404,1,10,127,1302,1610,11
2320127002,2016-04-22,5583,0,0,266,1174,1851,0
2320127002,2016-04-23,5079,0,0,242,1129,1804,0
2320127002,2016-04-24,4165,0,0,204,1236,1725,0
2320127002,2016-04-25,3588,3,5,152,1280,1654,8
2320127002,2016-04-26,3409,0,0,147,1293,1632,0
2320127002,2016-04-27,1715,0,0,82,1358,1481,0
2320127002,2016-04-28,1532,0,0,76,1364,1473,0
2320127002,2016-04-29,924,0,0,45,1395,1410,0
2320127002,2016-04-30,4571,0,0,234,1206,1779,0
2320127002,2016-05-01,772,0,0,40,1400,1403,0
2320127002,2016-05-02,3634,5,6,123,1306,1613,11
2320127002,2016-05-03,7443,20,10,206,1204,1878,30
2320127002,2016-05-04,1201,0,0,52,1388,1426,0
2320127002,2016-05-05,5202,0,11,223,1206,1780,11
2320127002,2016-05-06,4878,0,0,204,1236,1742,0
2320127002,2016-05-07,7379,0,0,319,1121,1972,0
2320127002,2016-05-08,5161,0,0,247,1193,1821,0
2320127002,2016-05-09,3090,0,0,145,1295,1630,0
2320127002,2016-05-10,6227,0,0,290,1150,1899,0
2320127002,2016-05-11,6424,0,0,300,1140,1903,0
2320127002,2016-05-12,2661,0,0,128,830,1125,0
2347167796,2016-04-12,10113,28,13,320,964,2344,41
2347167796,2016-04-13,10352,19,32,195,676,2038,51
2347167796,2016-04-14,10129,1,48,206,705,2010,49
2347167796,2016-04-15,10465,1,24,284,720,2133,25
2347167796,2016-04-16,22244,66,72,268,968,2670,138
2347167796,2016-04-17,5472,1,7,249,508,1882,8
2347167796,2016-04-18,8247,11,16,206,678,1944,27
2347167796,2016-04-19,6711,0,7,382,648,2346,7
2347167796,2016-04-20,10999,11,43,269,1011,2198,54
2347167796,2016-04-21,10080,23,26,208,761,2048,49
2347167796,2016-04-22,7804,9,27,206,781,1946,36
2347167796,2016-04-23,16901,32,35,360,591,2629,67
2347167796,2016-04-24,9471,0,0,360,584,2187,0
2347167796,2016-04-25,9482,15,11,277,653,2095,26
2347167796,2016-04-26,5980,0,0,227,732,1861,0
2347167796,2016-04-27,11423,26,9,295,623,2194,35
2347167796,2016-04-28,5439,0,0,229,764,1854,0
2347167796,2016-04-29,42,0,0,4,2,403,0
2873212765,2016-04-12,8796,2,21,356,1061,1982,23
2873212765,2016-04-13,7618,0,8,404,1028,2004,8
2873212765,2016-04-14,7910,0,0,331,1109,1893,0
2873212765,2016-04-15,8482,0,0,448,992,2063,0
2873212765,2016-04-16,9685,47,1,305,1087,2148,48
2873212765,2016-04-17,2524,0,8,160,1272,1529,8
2873212765,2016-04-18,7762,1,6,311,1122,1890,7
2873212765,2016-04-19,7948,0,0,389,1051,1956,0
2873212765,2016-04-20,9202,22,5,378,1035,2094,27
2873212765,2016-04-21,8859,2,10,371,1057,1970,12
2873212765,2016-04-22,7286,46,0,366,1028,2241,46
2873212765,2016-04-23,9317,28,5,330,1077,2021,33
2873212765,2016-04-24,6873,46,1,190,1203,1898,47
2873212765,2016-04-25,7373,0,0,359,1081,1907,0
2873212765,2016-04-26,8242,2,5,309,1124,1882,7
2873212765,2016-04-27,3516,46,0,197,1197,1966,46
2873212765,2016-04-28,7913,28,7,213,1192,1835,35
2873212765,2016-04-29,7365,20,23,206,1191,1780,43
2873212765,2016-04-30,8452,5,20,248,1167,1830,25
2873212765,2016-05-01,7399,7,18,196,1219,1739,25
2873212765,2016-05-02,7525,0,7,334,1099,1878,7
2873212765,2016-05-03,7412,1,6,363,1070,1906,7
2873212765,2016-05-04,8278,0,0,420,1020,2015,0
2873212765,2016-05-05,8314,13,23,311,1093,1971,36
2873212765,2016-05-06,7063,0,5,370,1065,1910,5
2873212765,2016-05-07,4940,75,11,52,1302,1897,86
2873212765,2016-05-08,8168,46,0,326,1068,2096,46
2873212765,2016-05-09,7726,0,0,345,1095,1906,0
2873212765,2016-05-10,8275,0,0,373,1067,1962,0
2873212765,2016-05-11,6440,0,0,319,1121,1826,0
2873212765,2016-05-12,7566,0,0,268,720,1431,0
3372868164,2016-04-12,4747,0,0,280,1160,1788,0
3372868164,2016-04-13,9715,16,8,371,1045,2093,24
3372868164,2016-04-14,8844,6,25,370,1039,2065,31
3372868164,2016-04-15,7451,0,0,335,1105,1908,0
3372868164,2016-04-16,6905,0,0,356,1084,1908,0
3372868164,2016-04-17,8199,11,2,322,1105,1964,13
3372868164,2016-04-18,6798,20,7,343,1070,2014,27
3372868164,2016-04-19,7711,0,0,376,1064,1985,0
3372868164,2016-04-20,4880,15,3,274,1148,1867,18
3372868164,2016-04-21,8857,18,9,376,1037,2124,27
3372868164,2016-04-22,3843,0,0,206,1234,1669,0
3372868164,2016-04-23,7396,20,2,303,1115,1995,22
3372868164,2016-04-24,6731,14,7,292,1127,1921,21
3372868164,2016-04-25,5995,0,0,416,1024,2010,0
3372868164,2016-04-26,8283,22,2,333,1083,2057,24
3372868164,2016-04-27,7904,24,13,346,1057,2095,37
3372868164,2016-04-28,5512,0,0,385,1055,1972,0
3372868164,2016-04-29,9135,0,0,402,1038,2044,0
3372868164,2016-04-30,5250,17,4,300,1119,1946,21
3372868164,2016-05-01,3077,0,0,172,842,1237,0
3977333714,2016-04-12,8856,44,19,131,777,1450,63
3977333714,2016-04-13,10035,31,46,153,754,1495,77
3977333714,2016-04-14,7641,5,23,214,801,1433,28
3977333714,2016-04-15,9010,15,42,183,644,1468,57
3977333714,2016-04-16,13459,31,83,153,663,1625,114
3977333714,2016-04-17,10415,11,58,205,600,1529,69
3977333714,2016-04-18,11663,4,95,214,605,1584,99
3977333714,2016-04-19,12414,19,67,221,738,1638,86
3977333714,2016-04-20,11658,2,98,164,845,1554,100
3977333714,2016-04-21,6093,0,0,242,712,1397,0
3977333714,2016-04-22,8911,33,12,188,731,1481,45
3977333714,2016-04-23,12058,0,92,252,724,1638,92
3977333714,2016-04-24,14112,30,95,129,660,1655,125
3977333714,2016-04-25,11177,50,9,133,781,1570,59
3977333714,2016-04-26,11388,7,95,170,797,1551,102
3977333714,2016-04-27,7193,0,10,176,714,1377,10
3977333714,2016-04-28,7114,15,8,190,804,1407,23
3977333714,2016-04-29,10645,36,32,150,744,1545,68
3977333714,2016-04-30,13238,43,52,194,687,1650,95
3977333714,2016-05-01,10414,41,40,124,691,1501,81
3977333714,2016-05-02,16520,24,143,176,713,1760,167
3977333714,2016-05-03,14335,47,41,258,594,1710,88
3977333714,2016-05-04,13559,14,96,142,852,1628,110
3977333714,2016-05-05,12312,14,88,178,680,1618,102
3977333714,2016-05-06,11677,29,55,168,676,1590,84
3977333714,2016-05-07,11550,0,86,208,703,1574,86
3977333714,2016-05-08,13585,9,116,171,688,1633,125
3977333714,2016-05-09,14687,8,122,151,1159,1667,130
3977333714,2016-05-10,13072,1,115,196,676,1630,116
3977333714,2016-05-11,746,4,0,9,13,52,4
4020332650,2016-04-12,8539,4,15,331,712,3654,19
4020332650,2016-04-13,0,0,0,0,1440,1981,0
4020332650,2016-04-14,108,0,0,3,1437,2011,0
4020332650,2016-04-15,1882,36,18,87,1299,2951,54
4020332650,2016-04-16,1982,65,21,55,1222,3051,86
4020332650,2016-04-17,16,0,0,2,1438,1990,0
4020332650,2016-04-18,62,0,0,2,1438,1995,0
4020332650,2016-04-19,0,0,0,0,1440,1980,0
4020332650,2016-04-20,0,0,0,0,1440,1980,0
4020332650,2016-04-21,0,0,0,0,1440,1980,0
4020332650,2016-04-22,0,0,0,0,1440,1980,0
4020332650,2016-04-23,0,0,0,0,1440,1980,0
4020332650,2016-04-24,0,0,0,0,1440,1980,0
4020332650,2016-04-25,0,0,0,0,1440,1980,0
4020332650,2016-04-26,0,0,0,0,1440,1980,0
4020332650,2016-04-27,0,0,0,0,1440,1980,0
4020332650,2016-04-28,0,0,0,0,1440,1980,0
4020332650,2016-04-29,0,0,0,0,1440,1980,0
4020332650,2016-04-30,0,0,0,0,1440,1980,0
4020332650,2016-05-01,0,0,0,0,1440,1980,0
4020332650,2016-05-02,475,0,11,31,1350,2207,11
4020332650,2016-05-03,4496,0,0,174,950,2828,0
4020332650,2016-05-04,10252,13,46,346,531,3879,59
4020332650,2016-05-05,11728,38,42,196,916,3429,80
4020332650,2016-05-06,4369,0,0,177,855,2704,0
4020332650,2016-05-07,6132,0,0,184,1256,2975,0
4020332650,2016-05-08,5862,0,0,263,775,3089,0
4020332650,2016-05-09,4556,3,5,173,1225,2785,8
4020332650,2016-05-10,5546,0,0,206,774,2926,0
4020332650,2016-05-11,3689,2,8,134,1296,2645,10
4020332650,2016-05-12,590,0,0,21,721,1120,0
4057192912,2016-04-12,5394,0,0,164,1276,2286,0
4057192912,2016-04-13,5974,0,0,160,1280,2306,0
4057192912,2016-04-14,0,0,0,0,1440,1776,0
4057192912,2016-04-15,3984,3,6,88,873,1527,9
4319703577,2016-04-12,7753,0,0,0,1440,2115,0
4319703577,2016-04-13,8204,8,15,96,1234,2135,23
4319703577,2016-04-14,10210,1,9,339,589,2302,10
4319703577,2016-04-15,5664,0,0,228,752,1985,0
4319703577,2016-04-16,4744,0,0,194,724,1884,0
4319703577,2016-04-17,29,0,0,3,1363,1464,0
4319703577,2016-04-18,2276,1,9,58,824,1632,10
4319703577,2016-04-19,8925,0,0,311,604,2200,0
4319703577,2016-04-20,8954,0,18,306,671,2220,18
4319703577,2016-04-21,3702,0,0,34,1265,1792,0
4319703577,2016-04-22,4500,1,19,176,709,1886,20
4319703577,2016-04-23,4935,0,0,233,546,1945,0
4319703577,2016-04-24,4081,1,5,191,692,1880,6
4319703577,2016-04-25,9259,0,8,390,544,2314,8
4319703577,2016-04-26,9899,8,21,288,649,2236,29
4319703577,2016-04-27,10780,6,47,300,680,2324,53
4319703577,2016-04-28,10817,13,8,359,552,2367,21
4319703577,2016-04-29,7990,6,18,289,624,2175,24
4319703577,2016-04-30,8221,6,38,196,695,2092,44
4319703577,2016-05-01,1251,0,0,67,836,1593,0
4319703577,2016-05-02,9261,0,11,344,585,2270,11
4319703577,2016-05-03,9648,8,26,287,669,2235,34
4319703577,2016-05-04,10429,8,13,313,1106,2282,21
4319703577,2016-05-05,13658,27,34,328,957,2530,61
4319703577,2016-05-06,9524,6,11,314,692,2266,17
4319703577,2016-05-07,7937,3,28,279,586,2158,31
4319703577,2016-05-08,3672,0,0,153,603,1792,0
4319703577,2016-05-09,10378,2,14,374,490,2345,16
4319703577,2016-05-10,9487,3,12,329,555,2260,15
4319703577,2016-05-11,9129,3,18,311,574,2232,21
4319703577,2016-05-12,17,0,0,2,0,257,0
4388161847,2016-04-12,10122,0,0,0,1440,2955,0
4388161847,2016-04-13,10993,1,14,150,1275,3092,15
4388161847,2016-04-14,8863,10,35,219,945,2998,45
4388161847,2016-04-15,8758,0,0,299,837,3066,0
4388161847,2016-04-16,6580,6,9,253,609,3073,15
4388161847,2016-04-17,4660,0,0,201,721,2572,0
4388161847,2016-04-18,11009,27,8,239,1017,3274,35
4388161847,2016-04-19,10181,20,16,249,704,3015,36
4388161847,2016-04-20,10553,19,42,228,696,3083,61
4388161847,2016-04-21,10055,7,12,272,853,3069,19
4388161847,2016-04-22,12139,77,25,220,945,3544,102
4388161847,2016-04-23,13236,58,5,215,749,3306,63
4388161847,2016-04-24,10243,14,8,239,584,2885,22
4388161847,2016-04-25,12961,11,31,301,1054,3288,42
4388161847,2016-04-26,9461,14,23,224,673,2929,37
4388161847,2016-04-27,11193,11,48,241,684,3074,59
4388161847,2016-04-28,10074,19,9,234,878,2969,28
4388161847,2016-04-29,9232,13,16,236,1175,2979,29
4388161847,2016-04-30,12533,14,43,300,537,3283,57
4388161847,2016-05-01,10255,12,15,241,579,2926,27
4388161847,2016-05-02,10096,33,4,204,935,3147,37
4388161847,2016-05-03,12727,18,18,306,984,3290,36
4388161847,2016-05-04,12375,35,21,251,632,3162,56
4388161847,2016-05-05,9603,12,39,199,896,2899,51
4388161847,2016-05-06,13175,33,45,262,1100,3425,78
4388161847,2016-05-07,22770,120,56,260,508,4022,176
4388161847,2016-05-08,17298,107,38,178,576,3934,145
4388161847,2016-05-09,10218,6,19,258,1020,3013,25
4388161847,2016-05-10,10299,13,14,267,648,3061,27
4388161847,2016-05-11,10201,8,18,256,858,2954,26
4388161847,2016-05-12,3369,0,0,108,825,1623,0
4445114986,2016-04-12,3276,0,0,196,787,2113,0
4445114986,2016-04-13,2961,0,0,194,840,2095,0
4445114986,2016-04-14,3974,0,0,231,717,2194,0
4445114986,2016-04-15,7198,0,0,350,711,2496,0
4445114986,2016-04-16,3945,0,0,225,716,2180,0
4445114986,2016-04-17,2268,0,0,114,1219,1933,0
4445114986,2016-04-18,6155,25,6,162,1247,2248,31
4445114986,2016-04-19,2064,0,0,121,895,1954,0
4445114986,2016-04-20,2072,0,0,137,841,1974,0
4445114986,2016-04-21,3809,0,0,215,756,2150,0
4445114986,2016-04-22,6831,0,0,317,706,2432,0
4445114986,2016-04-23,4363,0,0,201,1239,2149,0
4445114986,2016-04-24,5002,0,0,244,1196,2247,0
4445114986,2016-04-25,3385,0,0,179,916,2070,0
4445114986,2016-04-26,6326,29,1,180,839,2291,30
4445114986,2016-04-27,7243,32,1,194,839,2361,33
4445114986,2016-04-28,4493,0,0,236,762,2203,0
4445114986,2016-04-29,4676,0,0,226,1106,2196,0
4445114986,2016-04-30,6222,0,0,290,797,2363,0
4445114986,2016-05-01,5232,0,0,240,741,2246,0
4445114986,2016-05-02,6910,27,4,200,667,2336,31
4445114986,2016-05-03,7502,30,2,233,725,2421,32
4445114986,2016-05-04,2923,0,0,180,897,2070,0
4445114986,2016-05-05,3800,2,6,185,734,2120,8
4445114986,2016-05-06,4514,0,0,229,809,2211,0
4445114986,2016-05-07,5183,26,4,108,866,2123,30
4445114986,2016-05-08,7303,0,8,308,733,2423,8
4445114986,2016-05-09,5275,0,0,266,641,2281,0
4445114986,2016-05-10,3915,0,0,231,783,2181,0
4445114986,2016-05-11,9105,34,22,232,622,2499,56
4445114986,2016-05-12,768,0,0,58,380,1212,0
4558609924,2016-04-12,5135,0,0,318,1122,1909,0
4558609924,2016-04-13,4978,19,7,127,1287,1722,26
4558609924,2016-04-14,6799,0,0,279,1161,1922,0
4558609924,2016-04-15,7795,17,30,262,1131,2121,47
4558609924,2016-04-16,7289,8,12,308,1112,1997,20
4558609924,2016-04-17,9634,7,19,304,1110,2117,26
4558609924,2016-04-18,8940,14,15,331,1080,2116,29
4558609924,2016-04-19,5401,1,9,248,1182,1876,10
4558609924,2016-04-20,4803,0,0,222,1218,1788,0
4558609924,2016-04-21,13743,6,21,432,844,2486,27
4558609924,2016-04-22,9601,20,25,273,1122,2094,45
4558609924,2016-04-23,6890,5,5,308,1122,2085,10
4558609924,2016-04-24,8563,0,0,395,1045,2173,0
4558609924,2016-04-25,8095,18,10,340,993,2225,28
4558609924,2016-04-26,9148,12,41,283,1062,2223,53
4558609924,2016-04-27,9557,27,14,312,1087,2098,41
4558609924,2016-04-28,9451,1,11,367,985,2185,12
4558609924,2016-04-29,7833,15,29,197,1096,1918,44
4558609924,2016-04-30,10319,7,29,293,1111,2105,36
4558609924,2016-05-01,3428,0,0,190,1121,1692,0
4558609924,2016-05-02,7891,0,0,383,1057,2066,0
4558609924,2016-05-03,5267,21,10,237,1172,1953,31
4558609924,2016-05-04,5232,0,0,252,1188,1842,0
4558609924,2016-05-05,10611,14,8,370,1048,2262,22
4558609924,2016-05-06,3755,0,0,202,1238,1722,0
4558609924,2016-05-07,8237,23,16,233,1116,1973,39
4558609924,2016-05-08,6543,66,35,238,1019,2666,101
4558609924,2016-05-09,11451,6,30,339,1065,2223,36
4558609924,2016-05-10,6435,11,18,220,1191,1889,29
4558609924,2016-05-11,9108,4,31,324,1081,2131,35
4558609924,2016-05-12,6307,0,0,247,736,1452,0
4702921684,2016-04-12,7213,0,0,263,718,2947,0
4702921684,2016-04-13,6877,0,0,258,777,2898,0
4702921684,2016-04-14,7860,0,0,271,772,2984,0
4702921684,2016-04-15,6506,1,8,256,944,2896,9
4702921684,2016-04-16,11140,3,24,335,556,3328,27
4702921684,2016-04-17,12692,12,66,302,437,3394,78
4702921684,2016-04-18,9105,22,30,191,890,3013,52
4702921684,2016-04-19,6708,10,8,179,757,2812,18
4702921684,2016-04-20,8793,2,29,260,717,3061,31
4702921684,2016-04-21,6530,4,41,144,901,2729,45
4702921684,2016-04-22,1664,0,0,72,1341,2241,0
4702921684,2016-04-23,15126,9,66,408,469,3691,75
4702921684,2016-04-24,15050,15,95,281,542,3538,110
4702921684,2016-04-25,9167,6,15,270,730,3064,21
4702921684,2016-04-26,6108,1,8,216,765,2784,9
4702921684,2016-04-27,7047,1,16,238,733,2908,17
4702921684,2016-04-28,9023,14,9,232,738,3033,23
4702921684,2016-04-29,9930,12,19,267,692,3165,31
4702921684,2016-04-30,10144,4,36,263,728,3115,40
4702921684,2016-05-01,0,0,0,0,1440,2017,0
4702921684,2016-05-02,7245,5,40,195,1131,2859,45
4702921684,2016-05-03,9454,0,0,313,729,3145,0
4702921684,2016-05-04,8161,4,15,251,757,3004,19
4702921684,2016-05-05,8614,8,5,241,745,3006,13
4702921684,2016-05-06,6943,1,16,207,682,2859,17
4702921684,2016-05-07,14370,5,46,439,577,3683,51
4702921684,2016-05-08,12857,9,125,192,1019,3287,134
4702921684,2016-05-09,8232,0,12,253,746,2990,12
4702921684,2016-05-10,10613,1,37,262,701,3172,38
4702921684,2016-05-11,9810,10,41,235,784,3069,51
4702921684,2016-05-12,2752,0,0,68,241,1240,0
5553957443,2016-04-12,11596,19,13,277,767,2026,32
5553957443,2016-04-13,4832,0,0,226,647,1718,0
5553957443,2016-04-14,17022,61,41,256,693,2324,102
5553957443,2016-04-15,16556,58,38,239,689,2254,96
5553957443,2016-04-16,5771,0,0,288,521,1831,0
5553957443,2016-04-17,655,0,0,46,943,1397,0
5553957443,2016-04-18,3727,0,0,206,622,1683,0
5553957443,2016-04-19,15482,69,28,249,756,2284,97
5553957443,2016-04-20,2713,0,0,148,598,1570,0
5553957443,2016-04-21,12346,47,42,177,801,2066,89
5553957443,2016-04-22,11682,25,16,270,781,2105,41
5553957443,2016-04-23,4112,0,0,272,443,1776,0
5553957443,2016-04-24,1807,0,0,104,582,1507,0
5553957443,2016-04-25,10946,51,11,201,732,2033,62
5553957443,2016-04-26,11886,40,18,238,750,2093,58
5553957443,2016-04-27,10538,16,16,206,745,1922,32
5553957443,2016-04-28,11393,49,13,165,727,1999,62
5553957443,2016-04-29,12764,46,15,270,709,2169,61
5553957443,2016-04-30,1202,0,0,84,506,1463,0
5553957443,2016-05-01,5164,0,0,237,436,1747,0
5553957443,2016-05-02,9769,23,9,227,724,1996,32
5553957443,2016-05-03,12848,26,29,247,812,2116,55
5553957443,2016-05-04,4249,0,0,224,651,1698,0
5553957443,2016-05-05,14331,44,29,241,692,2156,73
5553957443,2016-05-06,9632,21,9,229,761,1916,30
5553957443,2016-05-07,1868,0,0,96,902,1494,0
5553957443,2016-05-08,6083,3,8,210,505,1762,11
5553957443,2016-05-09,11611,59,22,251,667,2272,81
5553957443,2016-05-10,16358,61,40,265,707,2335,101
5553957443,2016-05-11,4926,0,0,195,628,1693,0
5553957443,2016-05-12,3121,8,6,48,222,741,14
5577150313,2016-04-12,8135,86,16,140,728,3405,102
5577150313,2016-04-13,5077,15,11,144,776,2551,26
5577150313,2016-04-14,8596,118,30,176,662,4022,148
5577150313,2016-04-15,12087,115,54,199,695,4005,169
5577150313,2016-04-16,14269,184,56,158,472,4274,240
5577150313,2016-04-17,12231,200,37,159,525,4552,237
5577150313,2016-04-18,9893,114,32,130,623,3625,146
5577150313,2016-04-19,12574,108,23,111,733,3501,131
5577150313,2016-04-20,8330,87,16,113,773,3192,103
5577150313,2016-04-21,10830,110,74,175,670,4018,184
5577150313,2016-04-22,9172,62,30,200,823,3329,92
5577150313,2016-04-23,7638,24,24,223,627,3152,48
5577150313,2016-04-25,6393,61,38,214,743,3374,99
5577150313,2016-04-26,5325,38,32,181,759,3088,70
5577150313,2016-04-27,6805,63,16,190,773,3294,79
5577150313,2016-04-28,9841,99,51,141,692,3580,150
5577150313,2016-04-29,7924,97,36,165,739,3544,133
5577150313,2016-04-30,12363,207,45,163,621,4501,252
5577150313,2016-05-01,13368,194,72,178,499,4546,266
5577150313,2016-05-02,7439,37,20,235,732,3014,57
5577150313,2016-05-03,11045,97,8,212,580,3795,105
5577150313,2016-05-04,5206,25,9,141,631,2755,34
5577150313,2016-05-05,7550,45,21,143,1153,3004,66
5577150313,2016-05-06,4950,41,16,79,1304,2643,57
5577150313,2016-05-07,0,0,0,0,1440,1819,0
5577150313,2016-05-08,0,0,0,0,1440,1819,0
5577150313,2016-05-09,3421,34,11,70,1099,2489,45
5577150313,2016-05-10,8869,104,37,194,639,3841,141
5577150313,2016-05-11,4038,45,15,63,257,1665,60
6117666160,2016-04-12,0,0,0,0,1440,1496,0
6117666160,2016-04-13,0,0,0,0,1440,1496,0
6117666160,2016-04-14,0,0,0,0,1440,1496,0
6117666160,2016-04-15,14019,0,6,513,921,2865,6
6117666160,2016-04-16,14450,7,15,518,502,2828,22
6117666160,2016-04-17,7150,0,0,312,702,2225,0
6117666160,2016-04-18,5153,0,0,241,759,2018,0
6117666160,2016-04-19,11135,0,0,480,425,2606,0
6117666160,2016-04-20,10449,26,10,349,587,2536,36
6117666160,2016-04-21,19542,11,19,294,579,4900,30
6117666160,2016-04-22,8206,0,0,402,413,2409,0
6117666160,2016-04-23,11495,0,0,512,468,2651,0
6117666160,2016-04-24,7623,0,0,362,711,2305,0
6117666160,2016-04-25,0,0,0,0,1440,1497,0
6117666160,2016-04-26,9543,0,7,352,1077,2450,7
6117666160,2016-04-27,9411,0,0,458,417,2576,0
6117666160,2016-04-28,3403,0,0,141,758,1879,0
6117666160,2016-04-29,9592,0,0,461,479,2560,0
6117666160,2016-04-30,6987,0,0,343,1040,2275,0
6117666160,2016-05-01,8915,0,0,397,525,2361,0
6117666160,2016-05-02,4933,0,0,236,1204,2044,0
6117666160,2016-05-03,0,0,0,0,1440,1496,0
6117666160,2016-05-04,2997,0,0,156,1279,1902,0
6117666160,2016-05-05,9799,0,0,487,479,2636,0
6117666160,2016-05-06,3365,0,0,133,673,1838,0
6117666160,2016-05-07,7336,0,0,412,456,2469,0
6117666160,2016-05-08,7328,0,0,318,517,2250,0
6117666160,2016-05-09,4477,0,0,197,125,1248,0
6290855005,2016-04-12,4562,0,0,199,1241,2560,0
6290855005,2016-04-13,7142,0,0,350,1090,2905,0
6290855005,2016-04-14,7671,0,0,363,1077,2952,0
6290855005,2016-04-15,9501,0,0,328,1112,2896,0
6290855005,2016-04-16,8301,0,0,258,1182,2783,0
6290855005,2016-04-17,7851,31,12,225,1172,3171,43
6290855005,2016-04-18,6885,0,0,271,1169,2766,0
6290855005,2016-04-19,7142,0,0,321,1119,2839,0
6290855005,2016-04-20,6361,0,0,258,1182,2701,0
6290855005,2016-04-21,0,0,0,0,1440,2060,0
6290855005,2016-04-22,6238,0,0,302,1138,2796,0
6290855005,2016-04-23,0,33,0,0,1407,2664,33
6290855005,2016-04-24,5896,0,0,258,1182,2703,0
6290855005,2016-04-25,7802,8,3,249,1180,2771,11
6290855005,2016-04-26,0,0,0,0,1440,2060,0
6290855005,2016-04-27,5565,0,0,287,1153,2743,0
6290855005,2016-04-28,5731,0,0,255,1185,2687,0
6290855005,2016-04-29,0,0,0,0,1440,2060,0
6290855005,2016-04-30,6744,0,0,324,1116,2843,0
6290855005,2016-05-01,9837,8,95,282,1055,3327,103
6290855005,2016-05-02,6781,0,0,268,1172,2725,0
6290855005,2016-05-03,6047,0,0,240,1200,2671,0
6290855005,2016-05-04,5832,0,0,272,1168,2718,0
6290855005,2016-05-05,6339,0,0,239,1201,2682,0
6290855005,2016-05-06,6116,0,0,305,1135,2806,0
6290855005,2016-05-07,5510,0,0,227,1213,2613,0
6290855005,2016-05-08,7706,0,0,251,1189,2712,0
6290855005,2016-05-09,6277,0,0,264,800,2175,0
6290855005,2016-05-10,0,0,0,0,1440,0,0
6775888955,2016-04-12,0,0,0,0,1440,1841,0
6775888955,2016-04-13,4053,17,18,85,1053,2400,35
6775888955,2016-04-14,5162,14,24,105,863,2507,38
6775888955,2016-04-15,1282,0,0,58,976,2127,0
6775888955,2016-04-16,4732,36,18,9,1377,2225,54
6775888955,2016-04-17,2497,5,24,19,1392,2067,29
6775888955,2016-04-18,8294,30,31,146,1233,2798,61
6775888955,2016-04-19,0,0,0,0,1440,1841,0
6775888955,2016-04-20,10771,70,113,178,1079,3727,183
6775888955,2016-04-21,0,0,0,0,1440,1841,0
6775888955,2016-04-22,637,0,0,20,1420,1922,0
6775888955,2016-04-23,0,0,0,0,1440,1841,0
6775888955,2016-04-24,2153,11,18,11,1400,2053,29
6775888955,2016-04-25,6474,33,13,92,1302,2484,46
6775888955,2016-04-26,7091,42,30,47,1321,2584,72
6775888955,2016-04-27,0,0,0,0,1440,1841,0
6775888955,2016-04-28,703,2,13,15,1410,1993,15
6775888955,2016-04-29,0,0,0,0,1440,1841,0
6775888955,2016-04-30,2503,3,9,84,1344,2280,12
6775888955,2016-05-01,2487,9,34,50,1347,2319,43
6775888955,2016-05-02,0,0,0,0,1440,1841,0
6775888955,2016-05-03,9,0,0,1,1439,1843,0
6775888955,2016-05-04,0,0,0,0,1440,1841,0
6775888955,2016-05-05,0,0,0,0,1440,1841,0
6775888955,2016-05-06,4697,12,35,75,1318,2496,47
6775888955,2016-05-07,1967,2,5,49,551,1032,7
6962181067,2016-04-12,10199,50,14,189,796,1994,64
6962181067,2016-04-13,5652,8,24,142,548,1718,32
6962181067,2016-04-14,1551,0,0,86,862,1466,0
6962181067,2016-04-15,5563,0,0,217,837,1756,0
6962181067,2016-04-16,13217,50,3,280,741,2173,53
6962181067,2016-04-17,10145,5,13,295,634,2027,18
6962181067,2016-04-18,11404,13,42,238,689,2039,55
6962181067,2016-04-19,10742,35,41,195,659,2046,76
6962181067,2016-04-20,13928,48,4,297,639,2174,52
6962181067,2016-04-21,11835,53,27,214,708,2179,80
6962181067,2016-04-22,10725,30,33,240,659,2086,63
6962181067,2016-04-23,20031,58,41,347,484,2571,99
6962181067,2016-04-24,5029,0,0,199,720,1705,0
6962181067,2016-04-25,13239,35,31,282,637,2194,66
6962181067,2016-04-26,10433,36,7,254,680,2012,43
6962181067,2016-04-27,10320,7,38,279,697,2034,45
6962181067,2016-04-28,12627,38,8,288,621,2182,46
6962181067,2016-04-29,10762,12,15,369,645,2254,27
6962181067,2016-04-30,10081,32,16,237,731,2002,48
6962181067,2016-05-01,5454,0,0,215,722,1740,0
6962181067,2016-05-02,12912,18,39,313,655,2162,57
6962181067,2016-05-03,12109,21,36,267,654,2072,57
6962181067,2016-05-04,10147,15,36,284,683,2086,51
6962181067,2016-05-05,10524,14,22,305,591,2066,36
6962181067,2016-05-06,5908,0,0,299,717,1850,0
6962181067,2016-05-07,6815,0,0,328,745,1947,0
6962181067,2016-05-08,4188,0,14,151,709,1659,14
6962181067,2016-05-09,12342,43,21,231,607,2105,64
6962181067,2016-05-10,15448,62,34,275,626,2361,96
6962181067,2016-05-11,6722,24,7,199,709,1855,31
6962181067,2016-05-12,3587,0,8,105,127,928,8
7007744171,2016-04-12,14172,53,8,355,1024,2937,61
7007744171,2016-04-13,12862,56,22,261,1101,2742,78
7007744171,2016-04-14,11179,34,6,304,1096,2668,40
7007744171,2016-04-15,5273,0,0,202,1238,2098,0
7007744171,2016-04-16,4631,0,0,203,1155,2076,0
7007744171,2016-04-17,8059,0,0,305,1135,2383,0
7007744171,2016-04-18,14816,48,31,284,1077,2832,79
7007744171,2016-04-19,14194,53,17,304,1066,2812,70
7007744171,2016-04-20,15566,60,33,347,1000,3096,93
7007744171,2016-04-21,13744,30,34,327,1049,2763,64
7007744171,2016-04-22,15299,64,50,261,1065,2889,114
7007744171,2016-04-23,8093,2,25,223,1190,2284,27
7007744171,2016-04-24,11085,0,0,419,1021,2667,0
7007744171,2016-04-25,18229,51,24,379,986,3055,75
7007744171,2016-04-26,15090,16,22,424,978,2939,38
7007744171,2016-04-27,13541,50,12,337,1041,2830,62
7007744171,2016-04-28,15128,16,16,401,1007,2836,32
7007744171,2016-04-29,20067,55,42,382,961,3180,97
7007744171,2016-04-30,3761,0,0,200,1240,2051,0
7007744171,2016-05-01,5600,0,0,237,1142,2225,0
7007744171,2016-05-02,13041,64,14,250,1112,2642,78
7007744171,2016-05-03,14510,58,31,330,1021,2976,89
7007744171,2016-05-04,0,0,0,0,1440,1557,0
7007744171,2016-05-05,15010,53,23,317,1047,2933,76
7007744171,2016-05-06,11459,44,13,247,1136,2553,57
7007744171,2016-05-07,0,0,0,0,111,120,0
7086361926,2016-04-12,11317,59,6,153,745,2772,65
7086361926,2016-04-13,5813,31,26,155,744,2516,57
7086361926,2016-04-14,9123,35,32,189,787,2734,67
7086361926,2016-04-15,8585,30,21,139,864,2395,51
7086361926,2016-04-16,31,0,0,3,1437,1635,0
7086361926,2016-04-17,0,0,0,0,1440,1629,0
7086361926,2016-04-18,9827,61,51,114,1136,2743,112
7086361926,2016-04-19,10688,67,69,124,671,2944,136
7086361926,2016-04-20,14365,87,13,145,797,2997,100
7086361926,2016-04-21,9469,19,6,206,758,2463,25
7086361926,2016-04-22,9753,58,59,153,762,2846,117
7086361926,2016-04-23,2817,0,0,90,1350,1965,0
7086361926,2016-04-24,3520,0,0,125,566,2049,0
7086361926,2016-04-25,10091,69,39,129,706,2752,108
7086361926,2016-04-26,10387,70,33,132,726,2781,103
7086361926,2016-04-27,11107,55,6,145,829,2693,61
7086361926,2016-04-28,11584,54,48,161,810,2862,102
7086361926,2016-04-29,7881,24,36,182,1198,2616,60
7086361926,2016-04-30,14560,42,17,308,584,2995,59
7086361926,2016-05-01,12390,30,15,258,685,2730,45
7086361926,2016-05-02,10052,66,26,139,737,2754,92
7086361926,2016-05-03,10288,57,36,152,761,2754,93
7086361926,2016-05-04,10988,45,12,135,843,2655,57
7086361926,2016-05-05,8564,24,14,149,1253,2386,38
7086361926,2016-05-06,12461,84,35,154,834,2924,119
7086361926,2016-05-07,12827,20,42,209,621,2739,62
7086361926,2016-05-08,10677,32,27,147,695,2534,59
7086361926,2016-05-09,13566,67,50,171,743,2960,117
7086361926,2016-05-10,14433,72,23,106,1182,2800,95
7086361926,2016-05-11,9572,57,40,128,757,2735,97
7086361926,2016-05-12,3789,5,4,58,343,1199,9
8053475328,2016-04-12,18060,116,8,123,1193,3186,124
8053475328,2016-04-13,16433,95,12,156,1177,3140,107
8053475328,2016-04-14,20159,119,5,193,1123,3411,124
8053475328,2016-04-15,20669,132,8,158,1142,3410,140
8053475328,2016-04-16,14549,96,6,83,1255,2867,102
8053475328,2016-04-17,18827,111,21,195,1113,3213,132
8053475328,2016-04-18,17076,102,6,195,1137,3133,108
8053475328,2016-04-19,15929,90,7,191,1152,3114,97
8053475328,2016-04-20,15108,89,5,158,695,3043,94
8053475328,2016-04-21,16057,100,6,170,1164,3103,106
8053475328,2016-04-22,10520,60,3,117,1260,2655,63
8053475328,2016-04-23,22359,125,14,223,741,3554,139
8053475328,2016-04-24,22988,129,33,182,1096,3577,162
8053475328,2016-04-25,20500,118,9,209,1104,3403,127
8053475328,2016-04-26,12685,68,5,185,1182,2846,73
8053475328,2016-04-27,12422,60,10,183,1187,2852,70
8053475328,2016-04-28,15447,90,9,153,1188,3062,99
8053475328,2016-04-29,12315,58,8,159,1215,2794,66
8053475328,2016-04-30,7135,27,1,131,1281,2408,28
8053475328,2016-05-01,1170,0,0,51,1389,1886,0
8053475328,2016-05-02,1969,0,0,95,1345,1988,0
8053475328,2016-05-03,15484,87,22,165,1166,3023,109
8053475328,2016-05-04,14581,89,8,123,1220,2918,97
8053475328,2016-05-05,14990,93,9,130,1208,2950,102
8053475328,2016-05-06,13953,90,15,90,1245,2859,105
8053475328,2016-05-07,19769,121,20,148,1076,3331,141
8053475328,2016-05-08,22026,125,14,228,1073,3589,139
8053475328,2016-05-09,12465,66,12,148,1214,2765,78
8053475328,2016-05-10,14810,96,10,115,1219,2926,106
8053475328,2016-05-11,12209,60,7,184,1189,2809,67
8053475328,2016-05-12,4998,28,4,39,839,1505,32
8253242879,2016-04-12,9033,40,2,154,1244,2044,42
8253242879,2016-04-13,8053,35,11,96,1298,1935,46
8253242879,2016-04-14,5234,29,16,33,1362,1705,45
8253242879,2016-04-15,2672,0,0,105,1335,1632,0
8253242879,2016-04-16,9256,6,51,115,1268,1880,57
8253242879,2016-04-17,10204,41,5,157,1237,2112,46
8253242879,2016-04-18,5151,16,16,130,1278,1829,32
8253242879,2016-04-19,4212,0,0,164,1276,1763,0
8253242879,2016-04-20,6466,5,18,216,1201,1931,23
8253242879,2016-04-21,11268,49,20,172,1199,2218,69
8253242879,2016-04-22,2824,0,0,120,1320,1651,0
8253242879,2016-04-23,9282,30,26,191,1193,2132,56
8253242879,2016-04-24,8905,41,4,82,1313,1976,45
8253242879,2016-04-25,6829,7,54,118,1261,1909,61
8253242879,2016-04-26,4562,19,14,108,1299,1813,33
8253242879,2016-04-27,10232,45,5,104,1286,2008,50
8253242879,2016-04-28,2718,11,16,20,1393,1580,27
8253242879,2016-04-29,6260,16,14,136,1257,1854,30
8253242879,2016-04-30,0,0,0,0,1440,0,0
8378563200,2016-04-12,7626,65,15,156,723,3635,80
8378563200,2016-04-13,12386,116,14,169,680,4079,130
8378563200,2016-04-14,13318,123,21,174,699,4163,144
8378563200,2016-04-15,14461,60,23,190,729,3666,83
8378563200,2016-04-16,11207,64,21,142,563,3363,85
8378563200,2016-04-17,2132,0,0,93,599,2572,0
8378563200,2016-04-18,13630,117,10,174,720,4157,127
8378563200,2016-04-19,13070,120,19,154,737,4092,139
8378563200,2016-04-20,9388,82,8,169,763,3787,90
8378563200,2016-04-21,15148,137,16,145,677,4236,153
8378563200,2016-04-22,12200,113,12,159,769,4044,125
8378563200,2016-04-23,5709,19,10,136,740,2908,29
8378563200,2016-04-24,3703,0,0,135,734,2741,0
8378563200,2016-04-25,12405,117,16,141,692,4005,133
8378563200,2016-04-26,16208,90,18,161,593,3763,108
8378563200,2016-04-27,7359,4,4,192,676,3061,8
8378563200,2016-04-28,5417,11,10,139,711,2884,21
8378563200,2016-04-29,6175,3,7,172,767,2982,10
8378563200,2016-04-30,2946,0,0,121,780,2660,0
8378563200,2016-05-01,11419,71,10,127,669,3369,81
8378563200,2016-05-02,6064,63,4,142,802,3491,67
8378563200,2016-05-03,8712,71,20,195,822,3784,91
8378563200,2016-05-04,7875,19,10,167,680,3110,29
8378563200,2016-05-05,8567,66,3,214,764,3783,69
8378563200,2016-05-06,7045,74,5,166,831,3644,79
8378563200,2016-05-07,4468,0,0,158,851,2799,0
8378563200,2016-05-08,2943,0,0,139,621,2685,0
8378563200,2016-05-09,8382,71,13,171,772,3721,84
8378563200,2016-05-10,6582,63,13,152,840,3586,76
8378563200,2016-05-11,9143,72,10,184,763,3788,82
8378563200,2016-05-12,4561,8,6,102,433,1976,14
8583815059,2016-04-12,5014,0,7,196,1237,2650,7
8583815059,2016-04-13,5571,2,23,163,1252,2654,25
8583815059,2016-04-14,3135,0,0,134,1306,2443,0
8583815059,2016-04-15,3430,0,0,65,1375,2505,0
8583815059,2016-04-16,5319,0,0,0,1440,2693,0
8583815059,2016-04-17,3008,0,0,0,1440,2439,0
8583815059,2016-04-18,3864,4,22,105,1309,2536,26
8583815059,2016-04-19,5697,7,10,166,1257,2668,17
8583815059,2016-04-20,5273,0,27,167,1246,2647,27
8583815059,2016-04-21,8538,35,18,158,1229,2883,53
8583815059,2016-04-22,8687,4,54,212,1170,2944,58
8583815059,2016-04-23,9423,7,44,238,1151,3012,51
8583815059,2016-04-24,8286,2,44,206,1188,2889,46
8583815059,2016-04-25,4503,18,6,122,1294,2547,24
8583815059,2016-04-26,10499,1,91,214,1134,3093,92
8583815059,2016-04-27,12474,77,5,129,1229,3142,82
8583815059,2016-04-28,6174,0,28,203,1209,2757,28
8583815059,2016-04-29,15168,46,67,258,1069,3513,113
8583815059,2016-04-30,10085,2,28,317,1093,3164,30
8583815059,2016-05-01,4512,10,2,117,1311,2596,12
8583815059,2016-05-02,8469,0,0,0,1440,2894,0
8583815059,2016-05-03,12015,0,0,0,1440,3212,0
8583815059,2016-05-04,3588,0,0,0,1440,2516,0
8583815059,2016-05-05,12427,0,0,70,1370,3266,0
8583815059,2016-05-06,5843,2,22,166,1250,2683,24
8583815059,2016-05-07,6117,0,0,250,1190,2810,0
8583815059,2016-05-08,9217,3,72,182,1183,2940,75
8583815059,2016-05-09,9877,66,4,110,1260,2947,70
8583815059,2016-05-10,8240,9,43,162,1226,2846,52
8583815059,2016-05-11,8701,5,71,177,1106,2804,76
8583815059,2016-05-12,0,0,0,0,1440,0,0
8792009665,2016-04-12,2564,0,0,116,831,2044,0
8792009665,2016-04-13,1320,0,0,82,806,1934,0
8792009665,2016-04-14,1219,0,0,84,853,1963,0
8792009665,2016-04-15,2483,0,0,126,937,2009,0
8792009665,2016-04-16,244,0,0,12,1428,1721,0
8792009665,2016-04-17,0,0,0,0,1440,1688,0
8792009665,2016-04-18,0,0,0,0,1440,1688,0
8792009665,2016-04-19,0,0,0,0,1440,1688,0
8792009665,2016-04-20,3147,0,10,139,744,2188,10
8792009665,2016-04-21,144,0,0,9,1431,1720,0
8792009665,2016-04-22,4068,1,20,195,817,2419,21
8792009665,2016-04-23,5245,8,45,232,795,2748,53
8792009665,2016-04-24,400,3,8,19,1410,1799,11
8792009665,2016-04-25,0,0,0,0,1440,1688,0
8792009665,2016-04-26,1321,0,0,80,1360,1928,0
8792009665,2016-04-27,1758,0,0,112,900,2067,0
8792009665,2016-04-28,6157,0,0,310,714,2780,0
8792009665,2016-04-29,8360,6,14,380,634,3101,20
8792009665,2016-04-30,7174,10,20,301,749,2896,30
8792009665,2016-05-01,1619,0,0,79,834,1962,0
8792009665,2016-05-02,1831,0,0,101,916,2015,0
8792009665,2016-05-03,2421,0,0,156,739,2297,0
8792009665,2016-05-04,2283,0,0,129,848,2067,0
8792009665,2016-05-05,0,0,0,0,1440,1688,0
8792009665,2016-05-06,0,0,0,0,1440,1688,0
8792009665,2016-05-07,0,0,0,0,1440,1688,0
8792009665,2016-05-08,0,0,0,0,1440,1688,0
8792009665,2016-05-09,0,0,0,0,1440,1688,0
8792009665,2016-05-10,0,0,0,0,48,57,0
8877689391,2016-04-12,23186,85,7,312,1036,3921,92
8877689391,2016-04-13,15337,108,18,216,1098,3566,126
8877689391,2016-04-14,21129,68,13,298,1061,3793,81
8877689391,2016-04-15,13422,106,1,281,1052,3934,107
8877689391,2016-04-16,29326,94,29,429,888,4547,123
8877689391,2016-04-17,15118,58,15,307,1060,3545,73
8877689391,2016-04-18,11423,29,5,191,1215,2761,34
8877689391,2016-04-19,18785,82,13,214,1131,3676,95
8877689391,2016-04-20,19948,73,19,225,1123,3679,92
8877689391,2016-04-21,19377,82,13,226,1119,3659,95
8877689391,2016-04-22,18258,61,2,236,1141,3427,63
8877689391,2016-04-23,11200,102,6,300,1032,3891,108
8877689391,2016-04-24,16674,64,1,227,1148,3455,65
8877689391,2016-04-25,12986,113,8,218,1101,3802,121
8877689391,2016-04-26,11101,22,3,258,1157,2860,25
8877689391,2016-04-27,23629,93,8,235,1104,3808,101
8877689391,2016-04-28,14890,58,8,231,1143,3060,66
8877689391,2016-04-29,9733,18,5,210,1207,2698,23
8877689391,2016-04-30,27745,124,4,223,1089,4398,128
8877689391,2016-05-01,10930,36,12,166,1226,2786,48
8877689391,2016-05-02,4790,0,0,105,1335,2189,0
8877689391,2016-05-03,10818,19,3,229,1189,2817,22
8877689391,2016-05-04,18193,66,8,212,1154,3477,74
8877689391,2016-05-05,14055,67,15,188,1170,3052,82
8877689391,2016-05-06,21727,96,17,232,1095,4015,113
8877689391,2016-05-07,12332,105,28,271,1036,4142,133
8877689391,2016-05-08,10686,17,4,245,1174,2847,21
8877689391,2016-05-09,20226,73,19,217,1131,3710,92
8877689391,2016-05-10,10733,18,11,224,1187,2832,29
8877689391,2016-05-11,21420,88,12,213,1127,3832,100
8877689391,2016-05-12,8064,23,1,137,770,1849,24
